XXXXXXXXXXX
X e       X
X   g  e  X
X         X
X  e   w  X
X         X
X  h  A e X
X         X
X e   m   X
X     e   X
XXXXXXXXXXX