XXXXXXXXXXX
X ezzz    X
X  zgz e  X
X  zzz    X
X  e   w  X
X         X
X  h  A e X
X         X
X e   m   X
X     e   X
XXXXXXXXXXX