XXXXXXXXXXXXXXXXXXXXXX
X                    X
X   e                X
X          g         X
X               e    X
X                    X
X             w      X
X                    X
X                    X
X        h    A      X
X                    X
X                    X
X   e            m   X
X                    X
X                    X
XXXXXXXXXXXXXXXXXXXXXX